_________________________________________________________
_________________________________________________________
_________________________________________________________
__________1__________1W__________________________________
________QQQQ_________WWW_________________________________
___________________1WWWWW________________________________
___________________WWWWWWW_______________________________
_________1____S__1WWWWWWWWW______________________________
FFFFFFFFFFFFFFFFFFFFFFFFFFFFFFFFFFFFFF___FFFFFFFFFFFFFFFF
