60
11111111111111111111111111111111111111111111111111
11111111111111111111111111111111111111111111111111
11111111111111111111111111111111111111111111111111
11111111111111111111111111111111111111111111111111
11111111111111111111111111111111111111111111111111
WWWWWWWWWWWWWWWWWWWWWWWWWWWWWWWWW1_WWWWWWWWWWWWWWW
________________________________W__W______________
________________________________W_1W______________
________________________________W1_W______________
________________________________W__W______________
________________________________W_1W______________
________________________________W1_W______________
________________________________W__W______________
________________________________W_1W______________
________________________________W1_W______________
________________________________W__W______________
________________________________W_1W______________
________________________________W1_W______________
________________________________W__W______________
________________________________W_1W______________
________________________________W1_W______________
________________________________W__W______________
________________________________W_1W______________
________________________________W1_W______________
________________________________W__W______________
________________________________W_1W______________
________________________________W1_W______________
________________________________W__W______________
________________________________W_1W______________
________________________________W1_W______________
________________________________W__W______________
________________________________W_1W______________
________________________________W1_W______________
________________________________W__W______________
________________________________W_1W______________
________________________________W1_W______________
________________________________W__W______________
________________________________W_1W______________
________________________________W1_W______________
________________________________W__W______________
________________________________W_1W______________
________________________________W1_W______________
________________________________W__W______________
________________________________W_1W______________
________________________________W1_W______________
________________________________W__W______________
________________________________W_1W______________
________________________________W1_W______________
________________________________W__W______________
________________________________W_1W______________
________________________________W1_W______________
________________________________W__W______________
________________________________W_1W______________
________________________________W1_W______________
________________________________W__W______________
________________________________W_1W______________
________________________________W1_W______________
________________________________W__W______________
________________________________W_1W______________
________________________________W1_W______________
________________________________W__W______________
________________________________W_1W______________
________________________________W1_W______________
________________________________W__W______________
________________________________W_1W______________
________________________________W1_W______________
________________________________W__W______________
________________________________W_1W______________
________________________________W1_W______________
________________________________W__W______________
________________________________W_1W______________
________________________________W1_W______________
________________________________W__W______________
________________________________W_1W______________
________________________________W1_W______________
________________________________W__W______________
________________________________W_1W______________
________________________________W1_W______________
________________________________W__W______________
________________________________W_1W______________
________________________________W1_W______________
________________________________W__W______________
________________________________W_1W______________
________________________________W1_W______________
________________________________W__W______________
________________________________W_1W______________
________________________________W1_W______________
________________________________W__W______________
________________________________W_1W______________
________________________________W1_W______________
________________________________W__W______________
________________________________W_1W______________
________________________________W1_W______________
________________________________W__W______________
________________________________W_1W______________
________________________________W1_W______________
________________________________W__W______________
________________________________W_1W______________
________________________________W1_W______________
________________________________W__W______________
________________________________W_1W______________
________________________________W1_W______________
________________________________W__W______________
________________________________W_1W______________
________________________________W1_W______________
________________________________W__W______________
________________________________W_1W______________
________________________________W1_W______________
________________________________W__W______________
________________________________W_1W______________
________________________________W1_W______________
________________________________W__W______________
________________________________W_1W______________
________________________________W1_W______________
________________________________W__W______________
________________________________W_1W______________
________________________________W1_W______________
________________________________W__W______________
________________________________W_1W______________
________________________________W1_W______________
________________________________W__W______________
________________________________W_1W______________
________________________________W1_W______________
________________________________W__W______________
________________________________W_1W______________
________________________________W1_W______________
________________________________W__W______________
________________________________W_1W______________
________________________________W1_W______________
________________________________W__W______________
________________________________W_1W______________
________________________________W1_W______________
________________________________W__W______________
________________________________W_1W______________
________________________________W1_W______________
________________________________W__W______________
________________________________W_1W______________
________________________________W1_W______________
________________________________W__W______________
________________________________W_1W______________
________________________________W1_W______________
________________________________W__W______________
________________________________W_1W______________
________________________________W1_W______________
________________________________W__W______________
________________________________W_1W______________
________________________________W1_W______________
________________________________W__W______________
________________________________W_1W______________
________________________________W1_W______________
________________________________W__W______________
________________________________W_1W______________
________________________________W1_W______________
________________________________W__W______________
________________________________W_1W______________
________________________________W1_W______________
________________________________W__W______________
________________________________W_1W______________
________________________________W1_W______________
________________________________W__W______________
________________________________W_1W______________
________________________________W1_W______________
________________________________W__W______________
________________________________W_1W______________
________________________________W1_W______________
________________________________W__W______________
________________________________W_1W______________
________________________________W1_W______________
________________________________W__W______________
_________W111111________________W_1W______________
__________WWWWWW111111__________W1_W______________
________________WWWWWW111111___P__________________
______________________WWWWWWWWWWWWWW______________
____________________________W111W_________________
____________________________W111W___S_S_S_S_S_S___
_____________________________W11W_________________
____________________________W111W_____W___________
W111________________________W1WW__________________
_WWW111_____________________W111W____S_S__________
____WWW111___________________WW1W________W__W__W__
_______WWWWWWWW_____________W111W_________________
____________________________W1WW__________________
____________________________W111_______W___W_W____
_____________________________WWW__________________
_______________________________________________S__
_____W_____W_________________________S____W_______
____________________________________W_W_W_________
________-_____________________________________Q___
______W111W_________________________________Q_____
_______WWW________________________________1_______
__________________________________________Q_______
___1W______________________________WW_____________
__1W______________________________W__W_____W______
_1W___________________________BB__W__W__BB________
_W_____________S_____Q____________W__W____________
_________________________________W____W___________
______________SS___WQWQW________W______W__________
_______________________________W________W_________
_____________SSS__________1__1W_W__PP__W_W11111111
FFFFFFFFFFFFFFFFFFFFFFFFFFFFFFFFFFFFFFFFFFFFFFFFFF
