20
__1_1_1__1__1__1__1_
____________________
____________________
____________________
____________________
_________QQ_________
____________________
____________--______
____________________
_______________WW___
____________________
__________________S_
__PW____________BB__
__FW__________B_____
__________WWW_______
________W___________
______W_____________
____W_______________
____W_______________
FFFF________________
