45
W________W
W________W
W________W
W________W
W___PP___W
W___FF___W
W________W
W________W
W________W
W________W
W________W
W________W
W________W
W________W
W________W
W________W
W________W
W________W
W________W
W________W
W________W
W________W
W________W
W________W
W________W
W________W
W________W
W________W
W________W
W________W
W________W
W________W
W________W
W________W
W________W
W________W
W________W
W________W
W________W
W________W
W________W
W________W
W________W
W________W
W________W
W________W
W________W
W________W
W________W
W________W
W________W
W________W
W________W
W________W
W________W
W________W
W________W
W________W
W________W
W________W
W________W
W________W
W________W
W________W
W________W
W________W
W________W
W________W
W________W
W________W
W________W
W________W
W________W
W________W
W________W
W________W
W________W
W________W
W________W
W________W
W________W
W________W
W________W
W________W
W________W
W___PP___W
W___WW___W
W________W
W________W
W________W
W________W
W________W
W________W
W________W
W________W
W________W
W________W
W________W
W________W
WFFFFFFFFW
