99
W1________W
WWWW______W
W_____Q111W
W___WWWWWWW
W_________W
WWWW_W_SSSW
W____WWWWWW
W____WPPPPP
WQQ__WPPPPP
W____WPPPPP
W__QQWPPPPP
W____WPPPPP
WWW__WFFFFF
WWWWWWWWWWW
