60
_________________________________________________________
_________________________________________________________
_________________________________________________________
__________1__________1W__________________________________
________QQQQ_________WWW_________________________________
___________________1WWWWW________________________________
_____--____________WWWWWWW_______________________________
_________1____S__1WWWWWWWWW_________________________P____
FFFFFFFFFFFFFFFFFFFFFFFFFFFFFFFFFFFFFF___FFFFFFFFFFFFFFFF