100
______________________________S_____________________________W
______________________________W_____________________________W
______________________________W_____________________________W
______________________BQQQQB__W_____________________________W
______________________________W_____________________________W
______________________________W_____________________________W
__W___________________BQQQQB__W_____________________________W
__W_____________W____________WW_____________________________W
Q_W_________W_____W_________WWW_____________________________W
________W_________-------------_____________________________W
1_1W_____________________________Q__________________________W
WWWWW_______________________________________________________W
____________________________________________________________W
___________________________________---_____1________________W
____B_____________________________________BQB_______________W
__________1__________1W_____________________________________W
________QQQQ_________WWW____________________________________W
___________________1WWWWW________________BQBQB______________W
_____--____________WWWWWWW__________________________________W
_________1____S__1WWWWWWWWW__1___S____W_________1____S__P___W
FFFFFFFFFFFFFFFFFFFFFFFFFFFFFFFFFF____FFFFFFFFFFFFFFFFFFFFFFF