60
_________________________________________________________
___________________W_____________________________________
_________________________________________________________
_________________W_______________________________________
_________________________________________________________
___________________W_____________________________________
_________________________________________________________
_________________W_______________________________________
_________________________________________________________
___________________W_____________________________________
_________________________________________________________
_________________W_______________________________________
_________________________________________________________
___________________W_____________________________________
_________________________________________________________
_________________W_______________________________________
_________________________________________________________
___________________W_____________________________________
_________________________________________________________
_________________W______________P________________________
FFFFFFFFFFFFFFFFFFFFFFFFFFFFFFFFFFFFFF___FFFFFFFFFFFFFFFF