100
BBBBBBBBBBBBBBBBBBB__B_____________________________________________
BBBBBBBBBBBBBBB___111B_____________________________________________
BBBBBBBBBBBBBBB__BBBBB_____________________________________________
BBBBBBBBBBBBBBB1_____B_____________________________________________
BBBBBBBBBBBBBBBBB11__B_____________________________________________
BBBBBBBBBBBBBBBBBBB__B_____________________________________________
BBBBBBBBBBBBBBB___111B_____________________________________________
BBBBBBBBBBBBBBB__BBBBB_____________________________________________
BBBBBBBBBBBBBBB1_____B_____________________________________________
BBBBBBBBBBBBBBBBB11__B_____________________________________________
BBBBBBBBBBBBBBBBBBB__B_____________________________________________
BBBBBBBBBBBBBBB___111B_____________________________________________
BBBBBBBBBBBBBBB__BBBBB_____________________________________________
BBBBBBBBBBBBBBB1_____B_____________________________________________
BBBBBBBBBBBBBBBBB11__B_____________________________________________
BBBBBBBBBBBBBBBBBBB__B_____________________________________________
BBBBBBBBBBBBBBB___111B_____QQQQQQQQQQQQQQQQQQQQQQQQQQ______________
BBBBBBBBBBBBBBB__BBBBB_____________________________________________
BBBBBBBBBBBBBBB1_____B_____________________________________________
BBBBBBBBBBBBBBBBB11__B_____QQQQQQQQQQQQQQQQQQQQQQQQQQ______________
BBBBBBBBBBBBBBBBBBB__B_____________________________________________
BBBBBBBBBBBBBBB___111B_____________________________________________
BBBBBBBBBBBBBBB__BBBBB_____QQQQQQQQQQQQQQQQQQQQQQQQQQ______________
BBBBBBBBBBBBBBB1_____B_____________________________________________
BBBBBBBBBBBBBBBBB11__B_____________________________________________
BBBBBBBBBBBBBBBBBBB__B_____QQQQQQQQQQQQQQQQQQQQQQQQQQ______________
BBBBBBBBBBBBB_____111B_____________________________________________
________________BBBBBB_____________________________________________
___________________________QQQQQQQQQQQQQQQQQQQQQQQQQQ______________
___________________________________________________________________
________111__111______W__________________________________W___P_____
_FFFFFFFFFFFFFFFFFFFFFFFFFFFFFFFFFFFFFFFFFFFFFFFFFFFFFFFFFFFFFFFFFF